2222222222
2000000002
2130400002
2000200002
2000200002
2000203002
2000200002
2000200402
2000000002
2222222222
